ACER	EY S ER
BLUETOOTH	B L UW T UW TH
BROWSER	B R AW Z ER
CALCU	K AE L K UW
CODE	K OW D
CONNECT	K AH N EH K T
DEACTIVATE	D IY AE K T IH V EY T
DESKTOP	D EH S K T AA P
DOWNLOADS	D AW N L OW D Z
EGG	EH G
EXIT	EH G Z IH T
EXIT(2)	EH K S AH T
FACEBOOK	F EY S B UH K
GOOGLE	G UW G AH L
IDLE	AY D AH L
MESSENGER	M EH S AH N JH ER
MESSENGER(2)	M EH S IH N JH ER
MODEL	M AA D AH L
NOODLES	N UW D AH L Z
NOTES	N OW T S
OFF	AO F
ON	AA N
ON(2)	AO N
ONE	W AH N
ONE(2)	HH W AH N
OPEN	OW P AH N
PING	P IH NG
REBOOT	R IY B UW T
RESTART	R IY S T AA R T
SHOW	SH OW
SHUTDOWN	SH AH T D AW N
STORE	S T AO R
SYSTEM	S IH S T AH M
TERMINAL	T ER M AH N AH L
TERMINATE	T ER M AH N EY T
THREE	TH R IY
TRAINER	T R EY N ER
TWO	T UW
VPN	V IY P IY N
YOUTUBE	Y UW T UW B
