ACER	EY S ER
BLUETOOTH	B L UW T UW TH
BROWSER	B R AW Z ER
CODE	K OW D
CONNECT	K AH N EH K T
DEACTIVATE	D IY AE K T IH V EY T
DOWNLOADS	D AW N L OW D Z
EXIT	EH G Z IH T
EXIT(2)	EH K S AH T
FACEBOOK	F EY S B UH K
GOOGLE	G UW G AH L
IDLE	AY D AH L
MODEL	M AA D AH L
NOTES	N OW T S
OFF	AO F
ON	AA N
ON(2)	AO N
OPEN	OW P AH N
PING	P IH NG
REBOOT	R IY B UW T
RESTART	R IY S T AA R T
SHUTDOWN	SH AH T D AW N
SYSTEM	S IH S T AH M
TERMINAL	T ER M AH N AH L
TERMINATE	T ER M AH N EY T
VPN	V IY P IY N
YOUTUBE	Y UW T UW B
